height = 4 ; width = 8

Array index
(index)
    [ 00, 01, 02, 03, 04, 05, 06, 07,
      08, 09, 10, 11, 12, 13, 14, 15,
      16, 17, 18, 19, 20, 21, 22, 23,
      24, 25, 26, 27, 28, 29, 30, 31  ]

Offset (odd column)
(r,c)
    [ 0,0 0,1 0,2 0,3 0,4 0,5 0,6 0,7
      1,0 1,1 1,2 1,3 1,4 1,5 1,6 1,7
      2,0 2,1 2,2 2,3 2,4 2,5 2,6 2,7
      3,0 3,1 3,2 3,3 3,4 3,5 3,6 3,7
      4,0 4,1 4,2 4,3 4,4 4,5 4,6 4,7 ]

                +                       -
  -  x  +           y               z
                        -       +
